CommonSimAtkTSY	\sf\os\cellularsrv\telephonyserverplugins\simatktsy\group\commonsimatktsy.mrp
GT_Techview_Baseline	\sf\os\buildtools\packaging\additionalutils\gt_techview_baseline.mrp
PacketLoopbackCSY	\sf\os\commsfw\serialserver\packetloopbackcsy\group\PacketLoopbackCSY.mrp
Testtools_ResourceHandler_Techview	\sf\app\techview\testapps\rschandler\TVResourceHandler\group\Testtools_ResourceHandler_techview.mrp
activitymanager	\sf\os\devicesrv\commonservices\activitymanager\group\activitymanager.mrp
additional_dummy	\sf\os\buildtools\packaging\dummy\additional_dummy.mrp
additional_unknown	\sf\os\buildtools\packaging\additionalutils\additional_unknown_cedar.mrp
app-engines_agnversit2	\sf\app\organizer\pimappservices\calendarvcalplugin\group\app-engines_agnversit2.mrp
app-engines_calendar	\sf\app\organizer\pimappservices\calendar\group\app-engines_calendar.mrp
app-engines_cntmodel	\sf\app\contacts\phonebookengines\contactsmodel\groupsql\app-engines_cntmodel.mrp
app-engines_documentation	\sf\app\organizer\pimappservices\appenginesdocs\app-engines_documentation.mrp
app-framework_amastart	\sf\mw\appsupport\applaunchservices\aftermarketappstarter\group\app-framework_amastart.mrp
app-framework_animation	\sf\mw\classicui\lafagnosticuifoundation\animation\group\app-framework_animation.mrp
app-framework_aplp	\sf\mw\appsupport\applaunchservices\applaunchplugins\group\app-framework_aplp.mrp
app-framework_apparc	\sf\mw\appsupport\appfw\apparchitecture\group\app-framework_apparc.mrp
app-framework_bmpanim	\sf\mw\classicui\lafagnosticuifoundation\bmpanimation\group\app-framework_bmpanim.mrp
app-framework_clock	\sf\mw\classicui\lafagnosticuifoundation\clockanim\group\app-framework_clock.mrp
app-framework_conarc	\sf\mw\appsupport\filehandling\fileconverterfw\group\app-framework_conarc.mrp
app-framework_cone	\sf\mw\classicui\lafagnosticuifoundation\cone\group\app-framework_cone.mrp
app-framework_documentation	\sf\mw\classicui\commonuisupport\uifwsdocs\app-framework_documentation.mrp
app-framework_egul	\sf\mw\classicui\lafagnosticuifoundation\uigraphicsutils\group\app-framework_egul.mrp
app-framework_emime	\sf\os\ossrv\genericservices\mimerecognitionfw\group\app-framework_emime.mrp
app-framework_errorresgt	\sf\mw\classicui\commonuisupport\errorresolverdata\group\app-framework_errorresgt.mrp
app-framework_etext	\sf\os\textandloc\textrendering\texthandling\group\app-framework_etext.mrp
app-framework_fepbase	\sf\mw\inputmethods\fep\frontendprocessor\group\app-framework_fepbase.mrp
app-framework_form	\sf\os\textandloc\textrendering\textformatting\group\app-framework_form.mrp
app-framework_gfxtranseffect	\sf\mw\classicui\lafagnosticuifoundation\graphicseffects\group\app-framework_gfxtranseffect.mrp
app-framework_grid	\sf\mw\classicui\commonuisupport\grid\group\app-framework_grid.mrp
app-framework_numberconversion	\sf\os\textandloc\textrendering\numberformatting\group\app-framework_numberconversion.mrp
app-framework_print	\sf\mw\appsupport\printingsupport\printinguisupport\group\app-framework_print.mrp
app-framework_shma	\sf\os\devicesrv\systemhealthmanagement\systemhealthmgr\group\app-framework_shma.mrp
app-framework_ssma	\sf\os\devicesrv\sysstatemgmt\systemstatemgr\group\app-framework_ssma.mrp
app-framework_ssplugins	\sf\os\devicesrv\sysstatemgmt\systemstateplugins\group\app-framework_ssplugins.mrp
app-framework_ssrefplugins	\sf\os\devicesrv\sysstatemgmt\systemstatereferenceplugins\group\app-framework_ssrefplugins.mrp
app-framework_sysstart	\sf\os\devicesrv\sysstatemgmt\systemstarter\group\app-framework_sysstart.mrp
app-framework_uiklafgt	\sf\mw\classicui\commonuisupport\uilaf\GROUP\app-framework_uiklafgt.mrp
app-framework_uikon	\sf\mw\classicui\commonuisupport\uikon\group\app-framework_uikon.mrp
app-framework_viewsrv	\sf\mw\appsupport\appfw\viewserver\group\app-framework_viewsrv.mrp
app-services_BackupRestoreNotification	\sf\mw\appsupport\commonappservices\backuprestorenotification\group\app-services_BackupRestoreNotification.mrp
app-services_TimeZoneLocalization	\sf\mw\appsupport\tzservices\tzloc\group\app-services_timezonelocalization.mrp
app-services_alarmserver	\sf\mw\appsupport\commonappservices\alarmserver\Group\app-services_alarmserver.mrp
app-services_calcon	\sf\app\organizer\pimappsupport\chinesecalendarconverter\group\app-services_calcon.mrp
app-services_chinesecalendaralgorithm	\sf\app\organizer\pimappsupport\chinesecalendaralg\group\app-services_chinesecalendaralgorithm.mrp
app-services_chtmltocrtconv	\sf\mw\appsupport\filehandling\htmltorichtextconverter\group\app-services_chtmltocrtconv.mrp
app-services_documentation	\sf\mw\appsupport\commonappservices\appservicesdocs\app-services_documentation.mrp
app-services_hlpmodel	\sf\app\helps\symhelp\helpmodel\group\app-services_hlpmodel.mrp
app-services_richtexttohtmlconv	\sf\mw\appsupport\filehandling\richtexttohtmlconverter\Group\app-services_richtexttohtmlconv.mrp
app-services_testalarmsrv	\sf\mw\appsupport\commonappservices\alarmservertest\TestAlarmSrv\app-services_testalarmsrv.mrp
app-services_tz	\sf\mw\appsupport\tzservices\tzserver\group\app-services_tz.mrp
app-services_tzcompiler	\sf\mw\appsupport\tzpcside\tzcompiler\group\app-services_tzcompiler.mrp
app-services_tzdb	\sf\mw\appsupport\tzservices\tzdatabase\group\app-services_tzdb.mrp
app-services_tzlocalizationrscfactory	\sf\mw\appsupport\tzservices\tzlocrscfactory\group\app-services_tzlocalizationrscfactory.mrp
app-services_versit	\sf\app\organizer\pimappsupport\vcardandvcal\group\app-services_versit.mrp
appinstall_metadata	\sf\mw\appinstall\appinstall_info\appinstall_metadata\appinstall_metadata.mrp
application-protocols_bookmarks	\sf\mw\netprotocols\applayerpluginsandutils\bookmarksupport\group\application-protocols_bookmarks.mrp
application-protocols_inetprotutil	\sf\os\ossrv\genericservices\httputils\group\application-protocols_inetprotutil.mrp
application-protocols_ineturilist	\sf\mw\netprotocols\applayerpluginsandutils\uripermissionservices\group\application-protocols_ineturilist.mrp
application-protocols_recognisers	\sf\mw\appsupport\contenthandling\webrecognisers\group\application-protocols_recognisers.mrp
appsupport_metadata	\sf\mw\appsupport\appsupport_info\appsupport_metadata\appsupport_metadata.mrp
base_crashflash_unistore2	\sf\os\kernelhwsrv\kernel\eka\drivers\crashflash\unistore2\base_crashflash_unistore2.mrp
base_documentation	\sf\os\kernelhwsrv\userlibandfileserver\basedocs\base_documentation.mrp
base_domain	\sf\os\kernelhwsrv\userlibandfileserver\domainmgr\group\base_domain.mrp
base_drivers_camerasc	\sf\os\kernelhwsrv\kernel\eka\drivers\camerasc\base_drivers_camerasc.mrp
base_drivers_unistore2	\sf\os\kernelhwsrv\kernel\eka\drivers\unistore2\base_drivers_unistore2.mrp
base_drivers_usbhostotg	\sf\os\kernelhwsrv\kernel\eka\drivers\usbho\base_drivers_usbhostotg.mrp
base_drivers_usbhostotg_usbware	\sf\os\kernelhwsrv\kernel\eka\drivers\usbho\usbd\base_drivers_usbhostotg_usbware.mrp
base_e32	\sf\os\kernelhwsrv\kernel\eka\base_e32.mrp
base_e32_compsupp	\sf\os\kernelhwsrv\kernel\eka\compsupp\base_e32_compsupp.mrp
base_e32_drivers_adc	\sf\os\kernelhwsrv\kernel\eka\drivers\adc\base_e32_drivers_adc.mrp
base_e32_drivers_bsp	\sf\os\kernelhwsrv\kernel\eka\drivers\bsp\base_e32_drivers_bsp.mrp
base_e32_drivers_debug	\sf\os\kernelhwsrv\kernel\eka\drivers\debug\group\base_e32_drivers_debug.mrp
base_e32_drivers_display	\sf\os\kernelhwsrv\kernel\eka\drivers\display\base_e32_drivers_display.mrp
base_e32_drivers_ecomm	\sf\os\kernelhwsrv\kernel\eka\drivers\ecomm\base_e32_drivers_ecomm.mrp
base_e32_drivers_ethernet	\sf\os\kernelhwsrv\kernel\eka\drivers\ethernet\base_e32_drivers_ethernet.mrp
base_e32_drivers_locmedia	\sf\os\kernelhwsrv\kernel\eka\drivers\locmedia\base_e32_drivers_locmedia.mrp
base_e32_drivers_media	\sf\os\kernelhwsrv\kernel\eka\drivers\media\base_e32_drivers_media.mrp
base_e32_drivers_sound	\sf\os\kernelhwsrv\kernel\eka\drivers\soundsc\base_e32_drivers_sound.mrp
base_e32_drivers_trace	\sf\os\kernelhwsrv\kernel\eka\drivers\trace\base_e32_drivers_trace.mrp
base_e32_drivers_usbcli	\sf\os\kernelhwsrv\kernel\eka\drivers\usbc\base_e32_drivers_usbcli.mrp
base_e32_euser	\sf\os\kernelhwsrv\kernel\eka\euser\base_e32_euser.mrp
base_e32_ewsrv	\sf\os\kernelhwsrv\kernel\eka\ewsrv\base_e32_ewsrv.mrp
base_e32_sd3c	\sf\os\kernelhwsrv\kernel\eka\drivers\medsd3c\base_e32_sd3c.mrp
base_e32_sd4c	\sf\os\kernelhwsrv\kernel\eka\drivers\pbus\mmc\sdcard\sdcard4c\base_e32_sd4c.mrp
base_e32test	\sf\os\kernelhwsrv\kerneltest\e32test\group\base_e32test.mrp
base_e32utils	\sf\os\kernelhwsrv\kerneltest\e32utils\group\base_e32utils.mrp
base_e32utils_restricted	\sf\os\kernelhwsrv\kerneltest\e32utils\group\restricted\base_e32utils_restricted.mrp
base_f32	\sf\os\kernelhwsrv\userlibandfileserver\fileserver\group\base_f32.mrp
base_f32_automounter	\sf\os\kernelhwsrv\userlibandfileserver\fileserver\automounter\base_f32_automounter.mrp
base_f32_eshell	\sf\os\kernelhwsrv\userlibandfileserver\fileserver\etshell\base_f32_eshell.mrp
base_f32_estart	\sf\os\kernelhwsrv\userlibandfileserver\fileserver\estart\base_f32_estart.mrp
base_f32_exfat	\sf\os\kernelhwsrv\userlibandfileserver\fileserver\internal\exfat\base_f32_exfat.mrp
base_f32_scomp	\sf\os\kernelhwsrv\userlibandfileserver\fileserver\scomp\base_f32_scomp.mrp
base_f32_sfat	\sf\os\kernelhwsrv\userlibandfileserver\fileserver\sfat\base_f32_sfat.mrp
base_f32_sfat32	\sf\os\kernelhwsrv\userlibandfileserver\fileserver\sfat32\base_f32_sfat32.mrp
base_f32_shostmassstorage	\sf\os\kernelhwsrv\userlibandfileserver\fileserver\shostmassstorage\base_f32_shostmassstorage.mrp
base_f32_siso9660	\sf\os\kernelhwsrv\userlibandfileserver\fileserver\iso9660\base_f32_siso9660.mrp
base_f32_smassstorage	\sf\os\kernelhwsrv\userlibandfileserver\fileserver\smassstorage\base_f32_smassstorage.mrp
base_f32_sntfs	\sf\os\kernelhwsrv\userlibandfileserver\fileserver\ntfs\base_f32_sntfs.mrp
base_f32_srofs	\sf\os\kernelhwsrv\userlibandfileserver\fileserver\srofs\base_f32_srofs.mrp
base_f32_srom	\sf\os\kernelhwsrv\userlibandfileserver\fileserver\srom\base_f32_srom.mrp
base_f32test	\sf\os\kernelhwsrv\kerneltest\f32test\group\base_f32test.mrp
base_hal	\sf\os\kernelhwsrv\halservices\hal\base_hal.mrp
base_loce32	\sf\os\textandloc\localisation\localesupport\mmpfiles\base_loce32.mrp
base_nandboot_unistore2	\sf\os\kernelhwsrv\unistore2\uiibootsupport\base_nandboot_unistore2.mrp
base_naviengine_usbhost	\sf\os\boardsupport\naviengine\naviengineusbhcd\base_naviengine_usbhost.mrp
base_ne1_tb_bootldr	\sf\os\boardsupport\naviengine\navienginebootldr\base_ne1_tb_bootldr.mrp
base_nec_naviengine	\sf\os\boardsupport\naviengine\navienginebsp\base_naviengine.mrp
base_nec_naviengine_flexible	\sf\os\boardsupport\naviengine\navienginebspflexible\base_naviengine_flexible.mrp
base_nec_naviengine_unistore2	\sf\os\boardsupport\naviengine\naviengineunistore2\base_nec_naviengine_unistore2.mrp
base_nec_naviengine_unistore2_flexible	\sf\os\boardsupport\naviengine\naviengineunistore2flex\base_nec_naviengine_unistore2_flexible.mrp
base_omaph4hrp	\sf\os\boardsupport\omaph4\omaph4bsp\h4\base_omaph4hrp.mrp
base_omaph4hrp_bootldr	\sf\os\boardsupport\omaph4\h4bootloader\base_omaph4hrp_bootldr.mrp
base_omaph4hrp_flexible	\sf\os\boardsupport\omaph4\omaph4bsp\h4\flexible\base_omaph4hrp_flexible.mrp
base_omaph4hrp_mebootldr	\sf\os\boardsupport\omaph4\omaph4minienvbootloader\base_omaph4hrp_mebootldr.mrp
base_omaph4hrp_sdio	\sf\os\boardsupport\omaph4\omaph4sdio\base_omaph4hrp_sdio.mrp
base_omaph4hrp_unistore2	\sf\os\boardsupport\omaph4\omaph4unistore2\base_omaph4hrp_unistore2.mrp
base_omaph4hrp_usbhostotg_usbware	\sf\os\boardsupport\omaph4\omapusbhotgdrivers\base_omaph4hrp_usbhostotg_usbware.mrp
base_sdiotests	\sf\os\kernelhwsrv\kerneltest\sdiotest\base_sdiotests.mrp
base_template	\sf\os\kernelhwsrv\bsptemplate\asspandvariant\base_template.mrp
base_template_usbhostotg	\sf\os\usb\usbbsptemplate\usbhostcntrldrivertemplate\base_template_usbhostotg.mrp
base_tiomap3	\sf\os\boardsupport\omap3variants\tiomap3bsp\base_tiomap3.mrp
base_tiomap3_flexible	\sf\os\boardsupport\omap3variants\tiomap3bsp\variant\34xx_sdp\flexible\base_tiomap3_flexible.mrp
base_tiomap3_lab	\sf\os\boardsupport\omap3variants\tiomap3bsp\variant\lab\base_tiomap3_lab.mrp
base_tiomap3_lab_sdio	\sf\os\boardsupport\omap3variants\tiomap3bsp\variant\lab_restricted\sdio\base_tiomap3_lab_sdio.mrp
base_tiomap3_lab_unistore2	\sf\os\boardsupport\omap3variants\tiomap3bsp\variant\lab_restricted\unistore2\base_tiomap3_lab_unistore2.mrp
base_tiomap3_sdio	\sf\os\boardsupport\omap3variants\tiomap3bsp\variant\34xx_sdp_restricted\sdio\base_tiomap3_sdio.mrp
base_tiomap3_unistore2	\sf\os\boardsupport\omap3variants\tiomap3bsp\base_tiomap3_unistore2.mrp
base_tiomap3_unistore2_flexible	\sf\os\boardsupport\omap3variants\tiomap3bsp\variant\34xx_sdp_restricted\unistore2\flexible\base_tiomap3_unistore2_flexible.mrp
base_ubootldr	\sf\os\kernelhwsrv\brdbootldr\ubootldr\base_ubootldr.mrp
base_wins	\sf\os\boardsupport\emulator\emulatorbsp\base_wins.mrp
base_wins_unistore2	\sf\os\boardsupport\emulator\unistore2emulatorsupport\base_wins_unistore2.mrp
bluetooth_accesshost	\sf\app\contacts\pimprotocols\pbap\group\bluetooth_accesshost.mrp
bluetooth_avrcp	\sf\mw\btservices\bluetoothappprofiles\avrcp\bluetooth_avrcp.mrp
bluetooth_btcomm	\sf\os\bt\bluetooth\btcomm\bluetooth_btcomm.mrp
bluetooth_btextnotifiers	\sf\os\bt\bluetooth\btextnotifiers\bluetooth_btextnotifiers.mrp
bluetooth_config	\sf\os\bt\bluetoothmgmt\btconfig\bluetooth_config.mrp
bluetooth_documentation	\sf\os\bt\bluetooth\btdocs\bluetooth_documentation.mrp
bluetooth_gavdp	\sf\os\bt\bluetooth\gavdp\group\bluetooth_gavdp.mrp
bluetooth_hci_v2_framework	\sf\os\bt\bthci\bthci2\group\bluetooth_hci_v2_framework.mrp
bluetooth_hci_v2_implementations	\sf\os\bt\bthci\hci2implementations\group\bluetooth_hci_v2_implementations.mrp
bluetooth_hciproxy	\sf\os\bt\bthci\hciextensioninterface\bluetooth_hciproxy.mrp
bluetooth_logger	\sf\os\bt\bluetooth\btlogger\group\bluetooth_logger.mrp
bluetooth_manager	\sf\os\bt\bluetoothmgmt\btmgr\bluetooth_manager.mrp
bluetooth_pan	\sf\os\bt\bluetoothcommsprofiles\btpan\group\bluetooth_pan.mrp
bluetooth_remotecontrol	\sf\os\devicesrv\accessoryservices\remotecontrolfw\group\bluetooth_remotecontrol.mrp
bluetooth_remotecontrol_reftsp	\sf\app\techview\shortlinkapps\reftsp\group\bluetooth_remotecontrol_refTSP.mrp
bluetooth_rom	\sf\os\bt\bluetoothmgmt\btrom\bluetooth_rom.mrp
bluetooth_sdp	\sf\os\bt\bluetooth\btsdp\bluetooth_sdp.mrp
bluetooth_stack	\sf\os\bt\bluetooth\btstack\bluetooth_stack.mrp
bluetooth_user	\sf\os\bt\bluetoothmgmt\bluetoothclientlib\bluetooth_user.mrp
boardsupport_metadata	\sf\os\boardsupport\boardsupport_info\boardsupport_metadata\boardsupport_metadata.mrp
bspsvs	\sf\os\boardsupport\haitest\bspsvs\group\bspsvs.mrp
bt_metadata	\sf\os\bt\bt_info\bt_metadata\bt_metadata.mrp
btservices_metadata	\sf\mw\btservices\btservices_info\btservices_metadata\btservices_metadata.mrp
buildtools_metadata	\sf\os\buildtools\buildtools_info\buildtools_metadata\buildtools_metadata.mrp
cellularsrv_metadata	\sf\os\cellularsrv\cellularsrv_info\cellularsrv_metadata\cellularsrv_metadata.mrp
classicui_metadata	\sf\mw\classicui\classicui_info\classicui_metadata\classicui_metadata.mrp
comms-infras_commdbshim	\sf\os\commsfw\commsconfig\commsdatabaseshim\group\comms-infras_commdbshim.mrp
comms-infras_commsbufs	\sf\os\commsfw\commsfwutils\commsbufs\group\comms-infras_commsbufs.mrp
comms-infras_commsdat	\sf\os\commsfw\commsfwtools\preparedefaultcommsdatabase\group\comms-infras_commsdat.mrp
comms-infras_commsdebugutility	\sf\os\persistentdata\traceservices\commsdebugutility\group\comms-infras_commsdebugutility.mrp
comms-infras_defaultcommdb	\sf\os\commsfw\commsfwtools\preparedefaultcommsdatabase\defaultcommdb\group\comms-infras_defaultcommdb.mrp
comms-infras_documentation	\sf\os\commsfw\commsfw_info\commsinfrastructuredocs\comms-infras_documentation.mrp
comms-infras_elements	\sf\os\commsfw\commsfwsupport\commselements\group\comms-infras_elements.mrp
comms-infras_esock	\sf\os\commsfw\datacommsserver\esockserver\group\comms-infras_esock.mrp
comms-infras_flogger	\sf\os\persistentdata\loggingservices\filelogger\group\comms-infras_flogger.mrp
comms-infras_installdefaultcommdb	\sf\os\commsfw\commsfwtools\preparedefaultcommsdatabase\installdefaultcommdb\group\comms-infras_installdefaultcommdb.mrp
comms-infras_nifman	\sf\os\networkingsrv\linklayercontrol\networkinterfacemgr\group\comms-infras_nifman.mrp
comms-infras_rootserver	\sf\os\commsfw\commsprocess\commsrootserverconfig\group\comms-infras_rootserver.mrp
comms-infras_tools	\sf\os\commsfw\commsfwtools\commstools\group\comms-infras_tools.mrp
commsfw_metadata	\sf\os\commsfw\commsfw_info\commsfw_metadata\commsfw_metadata.mrp
commsinfrastructuresvs	\sf\os\commsfw\commsinfrastructureapitest\commsinfrastructuresvs\group\commsinfrastructuresvs.mrp
connectivity_abclient	\sf\os\ossrv\genericservices\activebackupclient\group\connectivity_abclient.mrp
connectivity_backupengine	\sf\mw\remoteconn\backupandrestore\backupengine\group\connectivity_backupengine.mrp
connectivity_backuptest	\sf\mw\remoteconn\backupandrestore\backuptest\group\connectivity_backuptest.mrp
connectivity_documentation	\sf\mw\remoteconn\remoteconn_info\connectivitydoc\group\connectivity_documentation.mrp
contacts_metadata	\sf\app\contacts\contacts_info\contacts_metadata\contacts_metadata.mrp
dev_build_bintools_rcomp	*nosource*
dev_build_imgtools_buildrom	*nosource*
dev_build_imgtools_imglib	*nosource*
dev_build_imgtools_romtools	*nosource*
dev_build_imgtools_sisutils	*nosource*
developerlibrary_doc_source	\sf\os\buildtools\devlib\devlibhelp\developerlibrary_doc_source.mrp
deviceplatformrelease_metadata	\sf\os\deviceplatformrelease\deviceplatformrelease_info\deviceplatformrelease_metadata\deviceplatformrelease_metadata.mrp
devicesrv_metadata	\sf\os\devicesrv\devicesrv_info\devicesrv_metadata\devicesrv_metadata.mrp
graphics_bitgdi	\sf\os\graphics\graphicsdeviceinterface\bitgdi\group\graphics_bitgdi.mrp
graphics_commonheader	\sf\os\graphics\graphicsutils\commongraphicsheaders\group\graphics_commonheader.mrp
graphics_compositionbackend	\sf\os\graphics\graphicscomposition\compositionengineadaptation\group\graphics_compositionbackend.mrp
graphics_directgdi	\sf\os\graphics\graphicsdeviceinterface\directgdi\group\graphics_directgdi.mrp
graphics_directgdiadapter	\sf\os\graphics\graphicsdeviceinterface\directgdiadaptation\group\graphics_directgdiadapter.mrp
graphics_directgdiheaders	\sf\os\graphics\graphicsdeviceinterface\directgdiinterface\group\graphics_directgdiheaders.mrp
graphics_documentation	\sf\os\graphics\graphics_info\graphicsdocs\graphics_documentation.mrp
graphics_egl	\sf\os\graphics\egl\eglimplementation\group\graphics_egl.mrp
graphics_eglheaders	\sf\os\graphics\egl\eglinterface\group\graphics_eglheaders.mrp
graphics_eglrefimpl	\sf\os\graphics\egl\eglrefimpl\group\graphics_eglrefimpl.mrp
graphics_eglswitch	\sf\os\graphics\egl\eglswitch\group\graphics_eglswitch.mrp
graphics_egltest	\sf\os\graphics\egl\egltest\group\graphics_egltest.mrp
graphics_fbserv	\sf\os\graphics\fbs\fontandbitmapserver\group\graphics_fbserv.mrp
graphics_fntstore	\sf\os\textandloc\fontservices\fontstore\group\graphics_fntstore.mrp
graphics_fonts	\sf\os\textandloc\fontservices\referencefonts\group\graphics_fonts.mrp
graphics_freetype	\sf\os\textandloc\fontservices\freetypefontrasteriser\group\graphics_freetype.mrp
graphics_gce	\sf\os\graphics\graphicscomposition\graphicscompositionengine\group\graphics_gce.mrp
graphics_gdi	\sf\os\graphics\graphicsdeviceinterface\gdi\group\graphics_gdi.mrp
graphics_gditools	\sf\os\graphics\graphicstools\gdi_tools\group\graphics_gditools.mrp
graphics_gdtran	\sf\os\graphics\graphicstools\bitmapfonttools\group\graphics_gdtran.mrp
graphics_graphicsresource	\sf\os\graphics\graphicsresourceservices\graphicsresource\group\graphics_graphicsresource.mrp
graphics_graphicsresourceadapter	\sf\os\graphics\graphicsresourceservices\graphicsresourceadaptation\group\graphics_graphicsresourceadapter.mrp
graphics_iculayoutengine	\sf\os\textandloc\fontservices\textshaperplugin\group\graphics_iculayoutengine.mrp
graphics_itype	\sf\os\graphics\fbs\itypefontrasteriser\group\graphics_itype.mrp
graphics_metadata	\sf\os\graphics\graphics_info\graphics_metadata\graphics_metadata.mrp
graphics_opengles	\sf\os\graphics\opengles\openglesimplementation\group\graphics_opengles.mrp
graphics_openglesdisplayproperty	\sf\os\graphics\opengles\openglesdisplayproperties\group\graphics_openglesdisplayproperty.mrp
graphics_openglesheaders	\sf\os\graphics\opengles\openglesinterface\group\graphics_openglesheaders.mrp
graphics_openvg	\sf\os\graphics\openvg\openvgimplementation\group\graphics_openvg.mrp
graphics_openvgheaders	\sf\os\graphics\openvg\openvginterface\group\graphics_openvgheaders.mrp
graphics_openwfcinterface	\sf\os\graphics\graphicscomposition\openwfcinterface\group\graphics_openwfcinterface.mrp
graphics_openwfcompositionengine	\sf\os\graphics\graphicscomposition\openwfcompositionengine\group\graphics_openwfcompositionengine.mrp
graphics_openwfsupport	\sf\os\graphics\graphicscomposition\openwfsupport\group\graphics_openwfsupport.mrp
graphics_palette	\sf\os\graphics\graphicsdeviceinterface\colourpalette\group\graphics_palette.mrp
graphics_pdrstore	\sf\os\graphics\printingservices\printerdriversupport\group\graphics_pdrstore.mrp
graphics_printdrv	\sf\os\graphics\printingservices\printerdrivers\group\graphics_printdrv.mrp
graphics_screendriver	\sf\os\graphics\graphicsdeviceinterface\screendriver\group\graphics_screendriver.mrp
graphics_surfacemanager	\sf\os\graphics\graphicshwdrivers\surfacemgr\group\graphics_surfacemanager.mrp
graphics_surfaceupdate	\sf\os\graphics\graphicscomposition\surfaceupdate\group\graphics_surfaceupdate.mrp
graphics_testutils	\sf\app\techview\testapps\graphicstestutils\group\graphics_testutils.mrp
graphics_ui_bench	\sf\os\graphics\graphicstest\uibench\group\graphics_ui_bench.mrp
graphics_wserv	\sf\os\graphics\windowing\windowserver\group\graphics_wserv.mrp
graphics_wserv_std_plugins	\sf\os\graphics\windowing\windowserverplugins\group\graphics_wserv_std_plugins.mrp
helps_metadata	\sf\app\helps\helps_info\helps_metadata\helps_metadata.mrp
http_examples	\sf\mw\netprotocols\applayerprotocols\httpexamples\group\http_examples.mrp
http_protocol-plugin	\sf\mw\netprotocols\applayerpluginsandutils\httpprotocolplugins\group\http_protocol-plugin.mrp
http_service	\sf\mw\netprotocols\applayerprotocols\httpservice\group\http_service.mrp
http_transport-framework	\sf\mw\netprotocols\applayerprotocols\httptransportfw\group\http_transport-framework.mrp
http_transport-plugin	\sf\mw\netprotocols\applayerpluginsandutils\httptransportplugins\group\http_transport-plugin.mrp
infra-red_irda	\sf\os\bt\irda\irdastack\group\infra-red_irda.mrp
inputmethods_metadata	\sf\mw\inputmethods\inputmethods_info\inputmethods_metadata\inputmethods_metadata.mrp
install_config	\sf\mw\appinstall\installationservices\swiconfig\group\install_config.mrp
ipappprotocols_metadata	\sf\mw\ipappprotocols\ipappprotocols_info\ipappprotocols_metadata\ipappprotocols_metadata.mrp
ipappsrv_metadata	\sf\mw\ipappsrv\ipappsrv_info\ipappsrv_metadata\ipappsrv_metadata.mrp
kernelhwsrv_metadata	\sf\os\kernelhwsrv\kernelhwsrv_info\kernelhwsrv_metadata\kernelhwsrv_metadata.mrp
lbs_admin	\sf\os\lbs\locationmgmt\locationcore\group\lbs_admin.mrp
lbs_agps_positioning_module	\sf\os\lbs\datasourcemodules\gpspositioningmodule\group\lbs_agps_positioning_module.mrp
lbs_agpslocationmanager	\sf\os\lbs\locationmgmt\agpslocationmgr\group\lbs_agpslocationmanager.mrp
lbs_bt_positioning_module	\sf\os\lbs\datasourcemodules\bluetoothgpspositioningmodule\group\lbs_bt_positioning_module.mrp
lbs_datasourceplugins	\sf\os\lbs\datasourcemodules\agpsintegrationmodule\group\lbs_datasourceplugins.mrp
lbs_default_positioning_module	\sf\os\lbs\datasourcemodules\defaultpositioningmodule\group\lbs_default_positioning_module.mrp
lbs_gps_data_source_adaptation	\sf\os\lbs\datasourceadaptation\gpsdatasourceadaptation\group\lbs_gps_data_source_adaptation.mrp
lbs_locationmonitor	\sf\os\lbs\locationmgmt\locmonitor\lbslocmonitorserver\group\lbs_locationmonitor.mrp
lbs_locationserver	\sf\os\lbs\locationrequestmgmt\locationserver\group\lbs_locationserver.mrp
lbs_metadata	\sf\os\lbs\lbs_info\lbs_metadata\lbs_metadata.mrp
lbs_network_positioning_module	\sf\os\lbs\datasourcemodules\networkpositioningmodule\group\lbs_network_positioning_module.mrp
lbs_networkgateway	\sf\os\lbs\locationmgmt\networkgateway\group\lbs_networkgateway.mrp
lbs_networklocationmanager	\sf\os\lbs\locationmgmt\networklocationmgr\group\lbs_networklocationmanager.mrp
lbs_networkrequesthandler	\sf\os\lbs\locationrequestmgmt\networkrequesthandler\group\lbs_networkrequesthandler.mrp
lbs_networktest	\sf\os\lbs\lbstest\locationprotocoltest\group\lbs_networktest.mrp
lbs_npeintegrationmodule	\sf\os\lbs\datasourcemodules\npeintegmodule\group\lbs_npeintegrationmodule.mrp
lbs_privacyprotocolmodule	\sf\os\lbs\networkprotocolmodules\privacyprotocolmodule\group\lbs_privacyprotocolmodule.mrp
lbs_simulation_positioning_module	\sf\os\lbs\datasourcemodules\simulationpositioningmodule\group\lbs_simulation_positioning_module.mrp
lbs_suplprotocolmodule	\sf\os\lbs\networkprotocolmodules\suplprotocolmodule\group\lbs_suplprotocolmodule.mrp
lbs_suplproxyprotocolmodule	\sf\os\lbs\networkprotocolmodules\suplproxyprotocolmodule\group\lbs_suplproxyprotocolmodule.mrp
lbs_suplsmstrigger	\sf\mw\messagingmw\messagingfw\suplsmshandler\group\lbs_suplsmstrigger.mrp
lbs_suplwappush	\sf\mw\messagingmw\messagingfw\suplwappushhandler\group\lbs_suplwappush.mrp
messaging_biomsg	\sf\mw\messagingmw\messagingfw\biomsgfw\group\messaging_biomsg.mrp
messaging_config	\sf\mw\messagingmw\messagingfw\msgconf\group\messaging_config.mrp
messaging_email	\sf\app\messaging\email\pop3andsmtpmtm\group\messaging_email.mrp
messaging_email_imap	\sf\app\messaging\email\imap4mtm\group\messaging_email_imap.mrp
messaging_framework	\sf\mw\messagingmw\messagingfw\msgsrvnstore\group\messaging_framework.mrp
messaging_gmxml	\sf\app\messaging\messagingappbase\smilparser\GROUP\messaging_gmxml.mrp
messaging_metadata	\sf\app\messaging\messaging_info\messaging_metadata\messaging_metadata.mrp
messaging_mmssettings	\sf\app\messaging\mmsengine\mmssettings\group\messaging_mmssettings.mrp
messaging_mmssettings-config	\sf\app\messaging\mmsengine\mmsconf\messaging_mmssettings-config.mrp
messaging_obex	\sf\app\messaging\messagingappbase\obexmtms\Group\messaging_obex.mrp
messaging_schedulesend	\sf\mw\messagingmw\messagingfw\scheduledsendmtm\group\messaging_schedulesend.mrp
messaging_sendas2	\sf\mw\messagingmw\messagingfw\sendas\group\messaging_sendas2.mrp
messaging_sms	\sf\app\messaging\mobilemessaging\smsmtm\group\messaging_sms.mrp
messaging_test	\sf\mw\messagingmw\messagingfw\msgtest\group\messaging_test.mrp
messaging_urlhandler	\sf\mw\messagingmw\messagingfw\msgurlhandler\group\messaging_urlhandler.mrp
messaging_watcher	\sf\mw\messagingmw\messagingfw\watcherfw\group\messaging_watcher.mrp
messagingmw_metadata	\sf\mw\messagingmw\messagingmw_info\messagingmw_metadata\messagingmw_metadata.mrp
mm-protocols_SIP2_Com	\sf\mw\ipappprotocols\realtimenetprots\sipfw\Group\mm-protocols_SIP2_Com.mrp
mm-protocols_SipProvider	\sf\mw\ipappprotocols\sipproviderplugins\sipprovider\group\mm-protocols_SipProvider.mrp
mm-protocols_rtp	\sf\mw\ipappprotocols\realtimenetprots\rtp\group\mm-protocols_rtp.mrp
mm_metadata	\sf\os\mm\mm_info\mm_metadata\mm_metadata.mrp
mmmw_metadata	\sf\mw\mmmw\mmmw_info\mmmw_metadata\mmmw_metadata.mrp
mmsvs	\sf\os\mm\mmapitest\mmsvs\group\mmsvs.mrp
mtp_bt	\sf\mw\remoteconn\mtptransports\mtpbttransport\group\mtp_bt.mrp
mtp_calendardp	\sf\app\organizer\organizerdataproviders\mtpcalendardp\group\mtp_calendardp.mrp
mtp_contactdp	\sf\app\contacts\pimprotocols\mtpcontactdp\group\mtp_contactdp.mrp
mtp_documentation	\sf\mw\remoteconn\remoteconn_info\mtpdoc\group\mtp_documentation.mrp
mtp_filedp	\sf\mw\remoteconn\mtpdataproviders\mtpfileandfolderdp\group\mtp_filedp.mrp
mtp_framework	\sf\mw\remoteconn\mtpfws\mtpfw\group\mtp_framework.mrp
mtp_imagedp	\sf\mw\remoteconn\mtpdataproviders\mtpimagedp\group\mtp_imagedp.mrp
mtp_metadatadp	\sf\mw\remoteconn\mtpdataproviders\mtpmetadatadp\group\mtp_metadatadp.mrp
mtp_pictbridgedp	\sf\mw\remoteconn\mtpdataproviders\mtppictbridgedp\group\mtp_pictbridgedp.mrp
mtp_pimproxy	\sf\app\organizer\organizerdataproviders\mtppimproxy\group\mtp_pimproxy.mrp
mtp_ptpip	\sf\mw\remoteconn\mtptransports\mtpptpiptransport\group\mtp_ptpip.mrp
mtp_statusdp	\sf\mw\remoteconn\mtpdataproviders\mtpstatusdp\group\mtp_statusdp.mrp
mtp_taskdp	\sf\app\organizer\organizerdataproviders\mtptaskdp\group\mtp_taskdp.mrp
mtp_usbsic	\sf\mw\remoteconn\mtptransports\mtpusbtransport\group\mtp_usbsic.mrp
mtp_wmpextndp	\sf\mw\remoteconn\mtpdataproviders\mtpwmpextndp\group\mtp_wmpextndp.mrp
mtpcontroller	\sf\mw\remoteconn\mtptransports\mtpcontroller\group\mtpcontroller.mrp
multimedia_3gplibrary	\sf\os\mm\mmplugins\lib3gp\group\multimedia_3gplibrary.mrp
multimedia_a3f_acf	\sf\os\mm\devsound\a3facf\group\multimedia_a3f_acf.mrp
multimedia_a3f_acl	\sf\os\mm\mmhais\a3facl\group\multimedia_a3f_acl.mrp
multimedia_a3f_devsound	\sf\os\mm\devsound\a3fdevsound\group\multimedia_a3f_devsound.mrp
multimedia_a3f_devsoundadaptationinfo	\sf\os\mm\mmhais\a3fdevsoundcustomisation\group\multimedia_a3f_devsoundadaptationinfo.mrp
multimedia_a3f_refacladaptation	\sf\os\mm\mmhais\refacladapt\group\multimedia_a3f_refacladaptation.mrp
multimedia_a3f_refmmrc	\sf\os\mm\mmresourcemgmt\mmresctrl\group\multimedia_a3f_refmmrc.mrp
multimedia_a3f_serverstart	\sf\os\mm\devsound\a3fsrvstart\group\multimedia_a3f_serverstart.mrp
multimedia_a3f_traces	\sf\os\mm\devsound\a3ftrace\group\multimedia_a3f_traces.mrp
multimedia_common	\sf\os\mm\mmlibs\mmutilitylib\group\multimedia_common.mrp
multimedia_documentation	\sf\os\mm\mm_info\mmdocs\multimedia_documentation.mrp
multimedia_ecam_framework	\sf\os\mm\imagingandcamerafws\camerafw\group\multimedia_ecam_framework.mrp
multimedia_ecam_plugins	\sf\os\mm\mmplugins\cameraplugins\group\multimedia_ecam_plugins.mrp
multimedia_icl	\sf\os\mm\imagingandcamerafws\imagingfws\group\multimedia_icl.mrp
multimedia_icl_capsadaptation	\sf\os\mm\mmplugins\CAPSAdaptation\group\multimedia_icl_capsadaptation.mrp
multimedia_icl_plugin	\sf\os\mm\mmplugins\imagingplugins\group\multimedia_icl_plugin.mrp
multimedia_il_api	\sf\os\mm\omxil\mmilapi\group\multimedia_il_api.mrp
multimedia_il_api_pv	\sf\os\mm\mmpacketvideo\mmilapipv\group\multimedia_il_api_pv.mrp
multimedia_mdf	\sf\os\mm\mmdevicefw\mdf\group\multimedia_mdf.mrp
multimedia_mdf_devsound_api	\sf\os\mm\devsound\devsoundapi\group\multimedia_mdf_devsound_api.mrp
multimedia_mdf_devsound_hwdev	\sf\os\mm\devsound\hwdevapi\group\multimedia_mdf_devsound_hwdev.mrp
multimedia_mdf_devsound_pluginsupport	\sf\os\mm\devsound\devsoundpluginsupport\group\multimedia_mdf_devsound_pluginsupport.mrp
multimedia_mdf_devsound_refbtplugin	\sf\os\mm\devsound\sounddevbt\group\multimedia_mdf_devsound_refbtplugin.mrp
multimedia_mdf_devsound_refplugin	\sf\os\mm\devsound\devsoundrefplugin\group\multimedia_mdf_devsound_refplugin.mrp
multimedia_mmf	\sf\os\mm\mmlibs\mmfw\group\multimedia_mmf.mrp
multimedia_mmf_asr	\sf\os\mm\mmdevicefw\speechrecogsupport\group\multimedia_mmf_ASR.mrp
multimedia_mmf_plugin	\sf\os\mm\mmplugins\mmfwplugins\group\multimedia_mmf_plugin.mrp
multimedia_mobiletv_dvbh_hai	\sf\os\mm\mmhais\dvbhreceiverhai\hai\dvbh\group\multimedia_mobiletv_dvbh_hai.mrp
multimedia_omx_il_api	\sf\os\mm\omxil\omxilapi\group\multimedia_omx_il_api.mrp
multimedia_omx_il_comp	\sf\os\mm\omxil\omxilcomponentcommon\group\multimedia_omx_il_comp.mrp
multimedia_omx_il_comp_ref	\sf\os\mm\omxil\omxilrefcomps\ref_components\group\multimedia_omx_il_comp_ref.mrp
multimedia_omx_il_core	\sf\os\mm\omxil\omxilcore\group\multimedia_omx_il_core.mrp
multimedia_omx_il_pv_comps	\sf\os\mm\mmpacketvideo\omxilpvcomps\group\multimedia_omx_il_pv_comps.mrp
multimedia_pv_aac	\sf\os\mm\mmpacketvideo\mmpvcodecs\group\multimedia_pv_aac.mrp
multimedia_videohai	\sf\os\mm\mmhais\videohai\group\multimedia_videohai.mrp
multimedia_videorenderer	\sf\os\mm\mmswadaptation\videorenderer\group\multimedia_videorenderer.mrp
nbprotocols_smsstackv2	\sf\os\cellularsrv\smsprotocols\smsstack\group\nbprotocols_smsstackv2.mrp
netprotocols_metadata	\sf\mw\netprotocols\netprotocols_info\netprotocols_metadata\netprotocols_metadata.mrp
networking_bca	\sf\os\cellularsrv\basebandabstraction\basebandchanneladaptor\group\networking_bca.mrp
networking_c32bca	\sf\os\cellularsrv\basebandadaptationplugins\basebandchanneladaptorforc32\group\networking_c32bca.mrp
networking_csdagt	\sf\os\cellularsrv\telephonyprotocols\csdagt\group\networking_csdagt.mrp
networking_dhcp	\sf\os\networkingsrv\tcpiputils\dhcp\group\networking_dhcp.mrp
networking_dialog	\sf\os\commsfw\datacommsserver\networkingdialogapi\group\networking_dialog.mrp
networking_dialog_default	\sf\os\commsfw\datacommsserver\networkingdialogapi\default\networking_dialog_default.mrp
networking_dnd	\sf\os\networkingsrv\tcpiputils\dnd\group\networking_dnd.mrp
networking_dnsproxy	\sf\os\networkingsrv\networkprotocols\dnsproxy\group\networking_dnsproxy.mrp
networking_documentation	\sf\os\networkingsrv\networkingsrv_info\networkingdocs\networking_documentation.mrp
networking_ether802	\sf\os\networkingsrv\linklayerprotocols\ethernetnif\group\networking_ether802.mrp
networking_examplecode	\sf\os\networkingsrv\networkingtestandutils\networkingexamples\examplecode\group\networking_examplecode.mrp
networking_ftp_e	\sf\mw\netprotocols\applayerprotocols\ftpengine\group\networking_ftp_e.mrp
networking_general	\sf\os\networkingsrv\networkingsrv_info\networkingrom\group\networking_general.mrp
networking_genericscprparams	\sf\os\networkingsrv\linklayercontrol\genericscprparameters\group\networking_genericscprparams.mrp
networking_guqos	\sf\os\cellularsrv\telephonyprotocols\gprsumtsqosprt\group\networking_guqos.mrp
networking_inhook6	\sf\os\networkingsrv\networkprotocols\iphook\inhook6\group\networking_inhook6.mrp
networking_insock	\sf\os\networkingsrv\esockapiextensions\internetsockets\group\networking_insock.mrp
networking_integrationtest	\sf\os\networkingsrv\networkingtestandutils\networkingintegrationtest\Group\networking_integrationtest.mrp
networking_ipeventnotifier	\sf\os\networkingsrv\networkprotocols\ipeventnotifier\group\networking_ipeventnotifier.mrp
networking_ipproto	\sf\os\networkingsrv\networkcontrol\ipnetworklayer\group\networking_ipproto.mrp
networking_ipsec	\sf\os\networkingsrv\networksecurity\ipsec\group\networking_ipsec.mrp
networking_ipsecvpn	\sf\os\networkingsrv\networksecurity\ipsecvpn\group\networking_ipsecvpn.mrp
networking_iptransport	\sf\os\networkingsrv\networkcontrol\iptransportlayer\group\networking_iptransport.mrp
networking_mbmsparams	\sf\os\networkingsrv\linklayercontrol\mbmsparameters\group\networking_mbmsparams.mrp
networking_mobileip	\sf\os\networkingsrv\networkprotocols\mobileip\group\networking_mobileip.mrp
networking_napt	\sf\os\networkingsrv\tcpiputils\networkaddressandporttranslation\group\networking_napt.mrp
networking_netcon	\sf\os\commsfw\datacommsserver\networkcontroller\group\networking_netcon.mrp
networking_netperf	\sf\os\networkingsrv\networkingtestandutils\networkingperformancemeasurementtools\group\networking_netperf.mrp
networking_netups	\sf\os\networkingsrv\networkcontrol\commsuserpromptmgr\group\networking_netups.mrp
networking_nullagt	\sf\os\networkingsrv\linklayercontrol\nullagt\group\networking_nullagt.mrp
networking_packetlogger	\sf\os\networkingsrv\linklayerutils\packetlogger\group\networking_packetlogger.mrp
networking_pdp	\sf\os\cellularsrv\telephonyprotocols\pdplayer\group\networking_pdp.mrp
networking_pfqoslib	\sf\os\networkingsrv\networkcontrol\pfqoslib\group\networking_pfqoslib.mrp
networking_ppp	\sf\os\networkingsrv\linklayerprotocols\pppnif\group\networking_ppp.mrp
networking_predcomp	\sf\os\networkingsrv\pppcompressionplugins\predictorcompression\group\networking_predcomp.mrp
networking_psdagt	\sf\os\cellularsrv\telephonyprotocols\psdagt\group\networking_psdagt.mrp
networking_punycodeconverter	\sf\os\networkingsrv\tcpiputils\punycodeconv\group\networking_punycodeconverter.mrp
networking_qos	\sf\os\networkingsrv\networkcontrol\qosfwconfig\qos\group\networking_qos.mrp
networking_qos3gpp	\sf\os\cellularsrv\telephonyprotocols\qos3gppcpr\group\networking_Qos3GPP.mrp
networking_qosextnapi	\sf\os\cellularsrv\telephonyprotocols\qosextnapi\group\networking_qosextnapi.mrp
networking_qosipscpr	\sf\os\networkingsrv\networkcontrol\qosipscpr\group\networking_qosipscpr.mrp
networking_qoslib	\sf\os\networkingsrv\networkcontrol\qoslib\group\networking_qoslib.mrp
networking_rawipnif	\sf\os\cellularsrv\telephonyprotocols\rawipnif\group\networking_rawipnif.mrp
networking_slip	\sf\os\networkingsrv\linklayerprotocols\slipnif\group\networking_slip.mrp
networking_spud	\sf\os\cellularsrv\telephonyprotocols\secondarypdpcontextumtsdriver\group\networking_spud.mrp
networking_tcpip6	\sf\os\networkingsrv\networkprotocols\tcpipv4v6prt\group\networking_tcpip6.mrp
networking_telnet_e	\sf\mw\netprotocols\applayerprotocols\telnetengine\group\networking_telnet_e.mrp
networking_tls	\sf\os\networkingsrv\networksecurity\tls\group\networking_tls.mrp
networking_tunnelnif	\sf\os\networkingsrv\linklayerprotocols\tunnelnif\group\networking_tunnelnif.mrp
networking_umtsif	\sf\os\cellularsrv\telephonyprotocols\gprsumtsqosinterface\group\networking_umtsif.mrp
networkingsrv_metadata	\sf\os\networkingsrv\networkingsrv_info\networkingsrv_metadata\networkingsrv_metadata.mrp
nokia_boardsupport_metadata	\sf\os\boardsupport\boardsupport_info\nokia_boardsupport_metadata\nokia_boardsupport_metadata.mrp
nokia_buildtools_metadata	\sf\os\buildtools\buildtools_info\nokia_buildtools_metadata\nokia_buildtools_metadata.mrp
nokia_contacts_metadata	\sf\app\contacts\contacts_info\nokia_contacts_metadata\nokia_contacts_metadata.mrp
nokia_deviceplatformrelease_metadata	\sf\os\deviceplatformrelease\deviceplatformrelease_info\nokia_deviceplatformrelease_metadata\nokia_deviceplatformrelease_metadata.mrp
nokia_graphics_metadata	\sf\os\graphics\graphics_info\nokia_graphics_metadata\nokia_graphics_metadata.mrp
nokia_helps_metadata	\sf\app\helps\helps_info\nokia_helps_metadata\nokia_helps_metadata.mrp
nokia_kernelhwsrv_metadata	\sf\os\kernelhwsrv\kernelhwsrv_info\nokia_kernelhwsrv_metadata\nokia_kernelhwsrv_metadata.mrp
nokia_lbs_metadata	\sf\os\lbs\lbs_info\nokia_lbs_metadata\nokia_lbs_metadata.mrp
nokia_mm_metadata	\sf\os\mm\mm_info\nokia_mm_metadata\nokia_mm_metadata.mrp
nokia_model	\sf\os\deviceplatformrelease\nokia_system\nokia_model\nokia_model.mrp
nokia_netprotocols_metadata	\sf\mw\netprotocols\netprotocols_info\nokia_netprotocols_metadata\nokia_netprotocols_metadata.mrp
nokia_networkingsrv_metadata	\sf\os\networkingsrv\networkingsrv_info\nokia_networkingsrv_metadata\nokia_networkingsrv_metadata.mrp
nokia_organizer_metadata	\sf\app\organizer\organizer_info\nokia_organizer_metadata\nokia_organizer_metadata.mrp
nokia_remoteconn_metadata	\sf\mw\remoteconn\remoteconn_info\nokia_remoteconn_metadata\nokia_remoteconn_metadata.mrp
nokia_security_metadata	\sf\os\security\security_info\nokia_security_metadata\nokia_security_metadata.mrp
nokia_techview_metadata	\sf\app\techview\techview_info\nokia_techview_metadata\nokia_techview_metadata.mrp
nokia_textandloc_metadata	\sf\os\textandloc\textandloc_info\nokia_textandloc_metadata\nokia_textandloc_metadata.mrp
nokia_usb_metadata	\sf\os\usb\usb_info\nokia_usb_metadata\nokia_usb_metadata.mrp
obex	\sf\mw\remoteconn\obex\obexprotocol\group\obex.mrp
obex_extensionapis	\sf\mw\remoteconn\obex\obexextensionapi\group\obex_extensionapis.mrp
oeaddons_librt	\sf\os\ossrv\genericopenlibs\posixrealtimeextensions\group\oeaddons_librt.mrp
oetools_telnetd	\sf\mw\appsupport\openenvutils\telnetserver\group\oetools_telnetd.mrp
oetools_zsh	\sf\mw\appsupport\openenvutils\commandshell\group\oetools_zsh.mrp
openenv	\sf\os\ossrv\genericopenlibs\openenvcore\group\openenv.mrp
openenv_libstdcpp	\sf\os\ossrv\genericopenlibs\cppstdlib\group\openenv_libstdcpp.mrp
organizer_metadata	\sf\app\organizer\organizer_info\organizer_metadata\organizer_metadata.mrp
osrndtools_metadata	\sf\os\osrndtools\osrndtools_info\osrndtools_metadata\osrndtools_metadata.mrp
ossrv_metadata	\sf\os\ossrv\ossrv_info\ossrv_metadata\ossrv_metadata.mrp
osttracecompiler	*nosource*
persistentdata_metadata	\sf\os\persistentdata\persistentdata_info\persistentdata_metadata\persistentdata_metadata.mrp
product_cbr_config	\sf\os\deviceplatformrelease\symbianosbld\productionbldcbrconfig\product_cbr_config.mrp
product_tools	\sf\os\buildtools\toolsandutils\productionbldtools\product_tools.mrp
reference_roms_tb92	\sf\os\deviceplatformrelease\symbianosbld\cedarutils\tb92sfrom_obys\reference_roms_tb92.mrp
remoteconn_metadata	\sf\mw\remoteconn\remoteconn_info\remoteconn_metadata\remoteconn_metadata.mrp
rootcerts	\sf\os\security\cryptoservices\rootcertificates\rootcerts.mrp
security_asnpkcs	\sf\os\security\cryptoservices\asnpkcs\group\security_asnpkcs.mrp
security_authserver	\sf\os\security\authenticationservices\authenticationserver\group\security_authserver.mrp
security_caf2	\sf\os\security\contentmgmt\contentaccessfwfordrm\group\security_caf2.mrp
security_certman	\sf\os\security\cryptoservices\certificateandkeymgmt\group\security_certman.mrp
security_common	\sf\os\security\cryptomgmtlibs\securityutils\group\security_common.mrp
security_commonutils	\sf\os\security\cryptomgmtlibs\securitycommonutils\group\security_commonutils.mrp
security_config	\sf\os\security\securityanddataprivacytools\securityconfig\group\security_config.mrp
security_cryptospi_plugins	\sf\os\security\cryptoplugins\cryptospiplugins\group\security_cryptospi_plugins.mrp
security_cryptospi_strong	\sf\os\security\crypto\weakcryptospi\group\security_cryptospi_strong.mrp
security_cryptospi_weak	\sf\os\security\crypto\weakcryptospi\group\security_cryptospi_weak.mrp
security_cryptotokens	\sf\os\security\cryptomgmtlibs\cryptotokenfw\group\security_cryptotokens.mrp
security_documentation	\sf\os\security\cryptomgmtlibs\securitydocs\security_documentation.mrp
security_filetokens	\sf\os\security\cryptoservices\filebasedcertificateandkeystores\group\security_filetokens.mrp
security_makekeys	\sf\mw\appinstall\secureswitools\makekeys\group\security_makekeys.mrp
security_metadata	\sf\os\security\security_info\security_metadata\security_metadata.mrp
security_openssl	\sf\mw\appinstall\secureswitools\openssllib\security_openssl.mrp
security_reccafconfig	\sf\os\security\contentmgmt\cafrecogniserconfig\security_reccafconfig.mrp
security_rta	\sf\os\security\contentmgmt\referencedrmagent\RefTestAgent\group\security_rta.mrp
security_sistools	\sf\mw\appinstall\secureswitools\swisistools\group\security_sistools.mrp
security_streamingcaf	\sf\os\security\contentmgmt\cafstreamingsupport\group\security_streamingcaf.mrp
security_swi	\sf\mw\appinstall\installationservices\swi\group\security_swi.mrp
security_switools	\sf\mw\appinstall\secureswitools\swianalysistoolkit\group\security_switools.mrp
security_switools_device	\sf\mw\appinstall\installationservices\swidevicetools\group\security_switools_device.mrp
security_tlsprovider	\sf\os\networkingsrv\networksecurity\tlsprovider\group\security_tlsprovider.mrp
security_tools	\sf\os\security\securityanddataprivacytools\securitytools\group\security_tools.mrp
security_ups	\sf\os\security\authorisation\userpromptservice\group\security_ups.mrp
security_ups_techview	\sf\app\techview\securityapps\securityupstechview\group\security_ups_techview.mrp
security_ups_utils	\sf\os\security\authorisation\userpromptutils\group\security_ups_utils.mrp
securitysrv_metadata	\sf\mw\securitysrv\securitysrv_info\securitysrv_metadata\securitysrv_metadata.mrp
securitysrv_ocsp	\sf\mw\securitysrv\pkiutilities\ocsp\group\securitysrv_ocsp.mrp
ser-comms_c32	\sf\os\commsfw\serialserver\c32serialserver\group\ser-comms_c32.mrp
ser-comms_c32-config	\sf\os\commsfw\serialserver\c32serialserverconfig\ser-comms_c32-config.mrp
ser-comms_documentation	\sf\os\commsfw\serialserver\c32serialserverdocs\ser-comms_documentation.mrp
ser-comms_serialportcsy	\sf\os\commsfw\serialserver\serialportcsy\ser-comms_serialportcsy.mrp
servicediscoveryframework	\sf\mw\srvdiscovery\servicediscoveryandcontrol\pnp\group\servicediscoveryframework.mrp
srvdiscovery_metadata	\sf\mw\srvdiscovery\srvdiscovery_info\srvdiscovery_metadata\srvdiscovery_metadata.mrp
sysdeftools	\sf\os\buildtools\bldsystemtools\sysdeftools\group\sysdeftools.mrp
syslibs_FATCharsetConv	\sf\os\textandloc\charconvfw\fatfilenameconversionplugins\group\syslibs_FATCharsetConv.mrp
syslibs_bafl	\sf\os\ossrv\lowlevellibsandfws\apputils\group\syslibs_bafl.mrp
syslibs_centralrepository	\sf\os\persistentdata\persistentstorage\centralrepository\group\syslibs_centralrepository.mrp
syslibs_charconv	\sf\os\textandloc\charconvfw\charconv_fw\group\syslibs_charconv.mrp
syslibs_charconv_plugins	\sf\os\textandloc\charconvfw\charconvplugins\group\syslibs_charconv_plugins.mrp
syslibs_dbms	\sf\os\persistentdata\persistentstorage\dbms\group\syslibs_dbms.mrp
syslibs_documentation	\sf\os\ossrv\genericservices\syslibsdocs\syslibs_documentation.mrp
syslibs_ecom3	\sf\os\ossrv\lowlevellibsandfws\pluginfw\Group\syslibs_ecom3.mrp
syslibs_euserhl	\sf\os\ossrv\lowlevellibsandfws\genericusabilitylib\group\syslibs_euserhl.mrp
syslibs_ezlib2	\sf\os\ossrv\compressionlibs\ziplib\group\syslibs_ezlib2.mrp
syslibs_featmgr	\sf\os\persistentdata\featuremgmt\featuremgr\group\syslibs_featmgr.mrp
syslibs_featreg	\sf\os\persistentdata\featuremgmt\featureregistry\group\syslibs_featreg.mrp
syslibs_legacyminidomparser	\sf\os\xmlsrv\xml\legacyminidomparser\GROUP\syslibs_legacyminidomparser.mrp
syslibs_libxml2	\sf\os\xmlsrv\xml\libxml2libs\group\syslibs_libxml2.mrp
syslibs_logeng	\sf\os\persistentdata\loggingservices\eventlogger\group\syslibs_logeng.mrp
syslibs_pwrcli	\sf\os\devicesrv\resourcemgmt\powerandmemorynotificationservice\group\syslibs_pwrcli.mrp
syslibs_schsvr	\sf\os\ossrv\genericservices\taskscheduler\group\syslibs_schsvr.mrp
syslibs_sql	\sf\os\persistentdata\persistentstorage\sql\GROUP\syslibs_sql.mrp
syslibs_sqlite3	\sf\os\persistentdata\persistentstorage\sqlite3api\GROUP\syslibs_sqlite3.mrp
syslibs_stdlib	\sf\os\ossrv\genericopenlibs\cstdlib\group\syslibs_stdlib.mrp
syslibs_store	\sf\os\persistentdata\persistentstorage\store\group\syslibs_store.mrp
syslibs_sysagent2	\sf\os\ossrv\genericservices\systemagent\group\syslibs_sysagent2.mrp
syslibs_wbxmlparser	\sf\os\xmlsrv\xml\wbxmlparser\group\syslibs_wbxmlparser.mrp
syslibs_xml	\sf\os\xmlsrv\xml\xmlfw\group\syslibs_xml.mrp
syslibs_xmldom	\sf\os\xmlsrv\xml\xmldomandxpath\group\syslibs_xmldom.mrp
syslibs_xmlparser	\sf\os\xmlsrv\xml\xmlexpatparser\group\syslibs_xmlparser.mrp
syslibs_xmlparser2	\sf\os\xmlsrv\xml\xmllibxml2parser\group\syslibs_xmlparser2.mrp
system	\sf\os\deviceplatformrelease\foundation_system\systemdocs\group\system.mrp
system_model	\sf\os\deviceplatformrelease\foundation_system\system_model\system_model.mrp
sysutil	\sf\os\devicesrv\commonservices\sysutil\group\sysutil.mrp
techview_KeyClickRef	\sf\app\techview\controlpanel\keyclickref\Group\techview_KeyClickRef.mrp
techview_SimpleApp	\sf\app\techview\testapps\simpleapp\group\Techview_SimpleApp.mrp
techview_UsbUi	\sf\app\techview\shortlinkapps\techviewusbui\group\techview_usbui.mrp
techview_agenda	\sf\app\techview\pimapps\agenda\group\techview_agenda.mrp
techview_audio	\sf\app\techview\avapps\techviewaudio\Group\techview_audio.mrp
techview_bluetoothui	\sf\app\techview\shortlinkapps\bluetoothui\group\techview_bluetoothui.mrp
techview_cctlcolscheme	\sf\app\techview\controlpanel\cctlcolscheme\group\techview_cctlcolscheme.mrp
techview_cdb_dummy_orphanheader_checker	\sf\app\techview\toolkit\cdborphans\group\techview_cdb_dummy_orphanheader_checker.mrp
techview_contacts	\sf\app\techview\pimapps\contactstechview\group\techview_contacts.mrp
techview_contacui	\sf\app\techview\pimapps\contacui\group\techview_contacui.mrp
techview_cpumonitor	\sf\app\techview\utilityapps\cpumonitor\group\techview_cpumonitor.mrp
techview_eikstd	\sf\app\techview\techviewplat\eikstd\group\techview_eikstd.mrp
techview_epoc_ini	\sf\app\techview\toolkit\configfiles\techview_epoc_ini.mrp
techview_extras	\sf\app\techview\techviewui\techviewextras\group\techview_extras.mrp
techview_feps	\sf\app\techview\techviewplat\feps\group\techview_feps.mrp
techview_fepsetup	\sf\app\techview\controlpanel\fepsetup\group\techview_fepsetup.mrp
techview_help	\sf\app\techview\utilityapps\helptechview\group\techview_help.mrp
techview_iapstatusapp	\sf\app\techview\networkingapps\iapstatusapp\group\techview_iapstatusapp.mrp
techview_installapp	\sf\app\techview\installationapps\installapp\group\techview_installapp.mrp
techview_messagingui	\sf\app\techview\messagingapps\messagingui\Group\techview_messagingui.mrp
techview_metadata	\sf\app\techview\techview_info\techview_metadata\techview_metadata.mrp
techview_networking_agentnotifier	\sf\app\techview\networkingapps\networkingagentnotifier\group\techview_networking_agentnotifier.mrp
techview_networking_vpnui	\sf\app\techview\networkingapps\techviewvpnui\group\techview_networking_vpnui.mrp
techview_phoneui	\sf\app\techview\telephonyapps\techviewphoneui\group\techview_phoneui.mrp
techview_romkit	\sf\app\techview\toolkit\romkit\group\techview_romkit.mrp
techview_secui	\sf\app\techview\securityapps\secui\group\techview_secui.mrp
techview_shell	\sf\app\techview\techviewui\shell\group\techview_shell.mrp
techview_soundsetup	\sf\app\techview\controlpanel\soundsetup\group\techview_soundsetup.mrp
techview_startup	\sf\app\techview\techviewui\startup\group\techview_startup.mrp
techview_statuspane	\sf\app\techview\techviewui\statuspane\group\techview_statuspane.mrp
techview_timew	\sf\app\techview\utilityapps\timew\group\techview_timew.mrp
techview_uiklaf	\sf\app\techview\techviewplat\techviewuiklaf\GROUP\techview_uiklaf.mrp
telephony_commontsy	\sf\os\cellularsrv\telephonyserverplugins\common_tsy\group\telephony_commontsy.mrp
telephony_confidential	\sf\os\cellularsrv\cellularsrv_info\telephonyconfidentialdocs\telephony_confidential.mrp
telephony_dial	\sf\os\cellularsrv\telephonyutils\dial\group\telephony_dial.mrp
telephony_dispatcher	\sf\os\cellularsrv\telephonyserverplugins\ctsydispatchlayer\group\telephony_dispatcher.mrp
telephony_documentation	\sf\os\cellularsrv\cellularsrv_info\telephonydocs\telephony_documentation.mrp
telephony_etel	\sf\os\cellularsrv\telephonyserver\etelserverandcore\group\telephony_etel.mrp
telephony_etel3rdparty	\sf\os\cellularsrv\telephonyutils\etel3rdpartyapi\Group\telephony_etel3rdparty.mrp
telephony_etelmm	\sf\os\cellularsrv\telephonyserver\etelmultimode\group\telephony_etelmm.mrp
telephony_etelpckt	\sf\os\cellularsrv\telephonyserver\etelpacketdata\group\telephony_etelpckt.mrp
telephony_etelsat	\sf\os\cellularsrv\telephonyserver\etelsimtoolkit\group\telephony_etelsat.mrp
telephony_fax	\sf\os\cellularsrv\fax\faxclientandserver\Group\telephony_fax.mrp
telephony_hwrm	\sf\os\devicesrv\resourcemgmt\hwresourcesmgr\group\telephony_hwrm.mrp
telephony_hwrm-config	\sf\os\devicesrv\resourcemgmt\hwresourcesmgrconfig\telephony_hwrm-config.mrp
telephony_hwrmfmtx	\sf\os\devicesrv\resourceinterfaces\fmtransmittercontrol\group\telephony_hwrmfmtx.mrp
telephony_hwrmuiplugin	\sf\mw\appsupport\hwresourceadaptation\hwresourcemgruiplugin\group\telephony_hwrmuiplugin.mrp
telephony_mmtsy	\sf\os\cellularsrv\telephonyserverplugins\multimodetsy\group\telephony_mmtsy.mrp
telephony_phbksync	\sf\app\contacts\pimprotocols\phonebooksync\group\telephony_phbksync.mrp
telephony_simtsy	\sf\os\cellularsrv\telephonyserverplugins\simtsy\group\telephony_simtsy.mrp
telephony_tools_mocksy	\sf\os\cellularsrv\hwpluginsimulation\mocksy\group\telephony_tools_mocksy.mrp
telephony_watchers	\sf\os\cellularsrv\telephonyutils\telephonywatchers\group\telephony_watchers.mrp
testtools_autosmoketest	\sf\app\techview\buildverification\autosmoketest\Group\testtools_autosmoketest.mrp
testtools_burtestserver	\sf\os\buildtools\toolsandutils\burtestserver\Group\testtools_burtestserver.mrp
testtools_captools	\sf\os\buildtools\binanamdw_os\captools\group\testtools_captools.mrp
testtools_cdb	\sf\os\buildtools\toolsandutils\cdb\group\testtools_cdb.mrp
testtools_leavescan	\sf\os\buildtools\srcanamdw_os\leavescan\group\testtools_leavescan.mrp
testtools_migrationtool	\sf\os\buildtools\srcanamdw_os\migrationtool\group\testtools_migrationtool.mrp
testtools_smoketest	\sf\app\techview\buildverification\smoketest\Group\testtools_smoketest.mrp
testtools_stat_common_source	\sf\os\buildtools\toolsandutils\statsource\group\testtools_stat_common_source.mrp
testtools_stat_desktop	\sf\os\buildtools\toolsandutils\statdesktop\group\testtools_stat_desktop.mrp
testtools_stat_device_gt	\sf\os\buildtools\toolsandutils\statapi\group\testtools_stat_device_gt.mrp
testtools_stat_device_techview	\sf\os\buildtools\toolsandutils\statapi\group\testtools_stat_device_techview.mrp
testtools_systemmonitor	\sf\os\buildtools\toolsandutils\systemmonitor\group\testtools_systemmonitor.mrp
testtools_testdriver	\sf\os\buildtools\toolsandutils\testdriver\Group\testtools_testdriver.mrp
testtools_ucc	\sf\os\buildtools\toolsandutils\usecasecontroller\BuildScripts\group\testtools_ucc.mrp
testtools_utilities	\sf\os\persistentdata\loggingservices\rfilelogger\group\testtools_utilities.mrp
textandloc_metadata	\sf\os\textandloc\textandloc_info\textandloc_metadata\textandloc_metadata.mrp
tools_autotest	\sf\os\buildtools\toolsandutils\autotest\group\tools_autotest.mrp
tools_build	\sf\os\buildtools\bldsystemtools\buildsystemtools\group\tools_build.mrp
tools_cbr_tools	\sf\os\buildtools\toolsandutils\cbrtools\group\tools_cbr_tools.mrp
tools_cinidata	\sf\os\osrndtools\testexecfw1\cinidata\tools_cinidata.mrp
tools_debug_trace	\sf\os\persistentdata\traceservices\tracefw\ulogger\group\tools_debug_trace.mrp
tools_depcheck	\sf\os\buildtools\binanamdw_os\depcheck\tools_depcheck.mrp
tools_e32tools	\sf\os\buildtools\toolsandutils\e32tools\group\tools_e32tools.mrp
tools_evalid	\sf\os\buildtools\bintools_os\evalid\tools_evalid.mrp
tools_redistribution_cedar	\sf\os\buildtools\dist_os\redistributionwinceka2\tools_redistribution_cedar.mrp
tools_redistribution_common	\sf\os\buildtools\perltoolsplat_os\redistribution\tools_redistribution_common.mrp
tools_romkit	\sf\os\buildtools\imgtools_os\romkiteka2\group\tools_romkit.mrp
tools_s60_header_compatsymtb101sf	\sf\os\ossrv\genericservices\s60compatibilityheaders\groupsymtb101sf\tools_s60_header_compatsymtb101sf.mrp
tools_sdk_eng_emulator_launcher	\sf\os\buildtools\misccomponents\emulatorlauncher\group\tools_sdk_eng_emulator_launcher.mrp
tools_stlport	\sf\os\buildtools\toolsandutils\stlport\group\tools_stlport.mrp
tools_testconfigfileparser	\sf\os\buildtools\toolsandutils\testconfigfileparser\group\tools_testconfigfileparser.mrp
tools_testexecute	\sf\os\osrndtools\testexecfw1\testexecute\Group\tools_testexecute.mrp
tools_utils_cedar	\sf\os\deviceplatformrelease\symbianosbld\cedarutils\tools_utils_cedar.mrp
tools_utils_common	\sf\os\buildtools\bldsystemtools\commonbldutils\tools_utils_common.mrp
usb_documentation	\sf\os\usb\usbmgmt\usbclassandmgrdocs\usb_documentation.mrp
usb_manager	\sf\os\usb\usbmgmt\usbmgr\group\usb_manager.mrp
usb_metadata	\sf\os\usb\usb_info\usb_metadata\usb_metadata.mrp
usb_rndis	\sf\os\usb\usbmgmt\usbrndis\group\usb_rndis.mrp
wap-browser_wapbase	\sf\mw\netprotocols\applayerprotocols\wapbase\Group\wap-browser_wapbase.mrp
wap-browser_wappush	\sf\mw\messagingmw\messagingfw\wappushfw\group\wap-browser_wappush.mrp
wap-browser_wappushsupport	\sf\mw\netprotocols\applayerprotocols\wappushsupport\Group\wap-browser_wappushsupport.mrp
wap-stack_wapmessage	\sf\mw\netprotocols\wapstack\wapmessageapi\group\wap-stack_wapmessage.mrp
wlan_metadata	\sf\os\wlan\wlan_info\wlan_metadata\wlan_metadata.mrp
xmlsrv_metadata	\sf\os\xmlsrv\xmlsrv_info\xmlsrv_metadata\xmlsrv_metadata.mrp
